000000000000000000000000000000000000000000000000000000000000000000000000000000000000000000000000000000000000000000000000000000000000000000000000000000000000000000000000000000000000000000000000000000000000000000000000000000000000000000000b000000000000000000000000000000000000000000000000000000000000000000000000000000000000000000000000000000000000000000000000000000000000000000000000000000000000000000
0000000000000000000000000000000000000000000000000000000000000000000000000000000000000000000000000000000000000000000000000000000000000000000000000000000000000000000000000000000000000000000000000000000000000000000000000000000000000000000000000000000000000000000000000000000000000000000000000000000000000000000000000000000000000000000000000000000000000000000000000000000000000000000000000000000000000000
000000000000000000000000000000000000000000000000000000000000000000000000000000000000000000000000000b000000000000b00000000000000011111111100000000000000000000000000000000000000000000000000000000000000000000000000000000000000000000000000000000000000000000000000000000000000000000000000000000000000000000000000000000000000000000000000000000000000000000000000000000000000000000000000000000000000000000000
0000000000000000000000000000000000000000000000000000000000000000000000000000000000000000000000000000000000000000000000000000000000000000100000000000000000000000000000000000000000000000000000000000000000000000000000000000011000000000000000000000000000000000000000000000000000000000000000000000000000000000000000000000000000000000000000000000000000000000000000000000000000000000000000000000000000000000
00000000000000000000000000000000000000000000000000000000000000000000000000000000000b0000000000000000000000000000000000000000000000000000010000000000000000000000000000000000000000000000000000000000000000000000000000000000000110011100000000011100000000000000000000000000000000000000000000000000000000000000000000000000000000000000000000000000000000000000000000000000000000000000000000000000000000000000
000000000000000000000000000000000000000000000000000000000000000000000000000000000000000000000000000000111000000000000000001100011111100000100000000000000b000000000000000000000000000000000000000000000000000000000000000010000000000000010010000000000000000000001110000000000000000000000000000000000000000000000000000000000000000000000000000000000000000000000000000000000000000000000000000000000000000000
0000000000000000000000000000000000000000000000000000000000000000000000000000000000000000000000000000010001000000000000000010000000000000000100000000000000000000000000000000000000000000000000000000000000000000000000000000000000000b00000000000000100000000001000000000000000000000000000000000000000000000000000000000000000000000000000000000000000000000000000000000000000000000000000000000000000000000000
00000000000000000000000000000000000000000000000000000000000000000000000000000000000000000111100000001000001000000000000001000000000000000001000000000000000000000000000b0000000000000000000000000000000000000000000000000000000000000000000000000000000100000100000000000000000000000000000000000000000000000000000000000000000000000000000000000000000000000000000000000000000000000000000000000000000000000000
000000000000000000000000000000000000000000000000000000000000000000000000000000000000000010001000000100000001000000000000010h000000000111000100000000000000000000000000000000000000000000000000000000000000000000000000000001110000000000000000000000000000100000000000000000000000000000000000000000000000000000000000000000000000000000000000000000000000000000000000000000000000000000000000000000000000000000
0000000000000000000000000000000000000000000000000000000000000000000000000000000000000001000001000010000000010000000000000101000000111000000100000000000000000000000000000000000000000000000000000000000000000000000000000000000010000000000000000000000000000000000000000000000000000000000000000000000000000000000000000000000000000000000000000000000000000000000000000000000000000000000000000000000000000000
000000000000000000000000000000000000000000000000000000f000000000000000000000000000000010000000111100000000010000000000001000000000000000000100000000000000000000011100000000000000000000000000000000000000000000000000000000000000010000000000110000000000000000000000000000000000000000000000000000000100100000000000000000000000000000000000000000000000000000000000000000000000000000000000000000000000000000
00000000000000000000000000000000000000000000000000001110000000000000000000000000000111000000000000000011110010000000000010001110000000000001000000000000000000000000000000000000000000000111111111111111111111000000000000b0000000000011000000000000000000000000000000000000000000000000000000000000100100100100000000000000000000000000000000000000000000000000000000000000000000000000000000000000000000000000
00000000000000000000000000000001111111000000000000010010000000000001000000000000001000000111000000000000000010000000000010000000000000000h0100000000000000001110000000111000000000000000010001111111111111111100000000000000000000000000001000000011100000000000000000000000000000000000000000000100100100100100100000000000000000000000000000000000000000000000000000000000000000000000000000000000000000000000
00000000000000000000000t0000001000t0000000000000001000010000000000101000000000000100000000000000000011000000010000000000100000000111000001010000000000000000000000h000000000000000000000110001111111111111111100000000000000000000000000000000000000001000000000000000000000000000000000000000100100100100100100100100000000000000000000000000000000000000000000000000000000000000000000000000000000000000000000
0000000000000000000000000000010000000000000000000010000100000000010001000000000010000000000001000000000000000010000000001000000000000000000010000000000111000000001000000001110000000000110001111111111111111100000000000000000000000000000000000000000000000000000000000000000000000000000100100100100100100100100100100000000000000000000000000000000000000000000000000000000000000000000000000000000000000000
00000000000000000000000000000000000000000000t00S0100000100000000100000100000000000000000000000001100000000000000000000000000000000000011100010000000000000000000000000000000000000000000110001111111111111111100000000000000000000000000000000000000000000000000000000000000000000000000100100100100100100100100100100100100000000000000000000000000000000000000000000000000000000000000000000000000000000000000
0000000000000000000000000000f0000000000000000000100000010000000010000010000000000000L000000000s0000000000000000f000000000000000000000000000010000000000000f000000000000000f000000000000011000000000000000000000000000000000000000000000000000100000000001110000000000000000000000000000000000000000s000000000000000s00000000000000000000000000000000000000000000000000000000000000000000000000000000000000000000
1111111111111111111111000111111100100111111111111111111110001111111111111111111111111111111111111111111111111111111111111111111111111111111111111111111111111111111111111111111111111111111111111111111111111111111111110001000000000000001000000000000000000000000000000001111111111111111111111111111111111111111111111111111111111111111111111111111111111111111111111111111111111111111111111111111111111111
1111111111111111111111000111111100100111111111111111111110001111111111111111111111111111111111111111111111111111111111111111111111111111111111111111111111111111111111111111111111111111111111111111111111111111111111110000001000001110000000000111001000000000000000000001111111111111111111111111111111111111111111111111111111111111111111111111111111111111111111111111111111111111111111111111111111111111
1111111111111111111111000111111100100111111111111111111110001111111111111111111111111111111111111111111111111111111111111111111111111111111111111111111111111111111111111111111111111111111111111111111111111111111111110000000001000000000000000000000000000000000000000001111111111111111111111111111111111111111111111111111111111111111111111111111111111111111111111111111111111111111111111111111111111111